I:E0:0:0:0
I:E1:0:0:0
I:E2:0:0:0
I:E3:0:0:0
I:E4:0:0:0
I:E5:0:0:0
I:E6:0:0:0
I:E7:0:0:0
I:run_elected:0:0:0
